....................
.--..---.--..--..-..
.-G-.-GG.-G-.-G-.-..
.-G-.---.--..--..-..
.-G-.-GG.-.-.-......
.--..---.-.-.-...-..
....................
.........GGG........
.........###........
....................
....GGG.......GGG...
....###.......###...
....................
.1................X.
####################
