....................
.--..---.--..--..-..
.-G-.-GG.-G-.-G-.-..
.-G-.---.--..--..-..
.-G-.-GG.-.-.-......
.--..---.-.-.-...-..
....................
.........GCG........
.........###........
....................
....GGG.......GGG...
....###.......###...
....................
..1...............X.
########.....#######
