....................
....................
.........BX.........
.......######.......
A.G..............G.B
####..G.G.G.G...####
.......G.G.GCG......
......--------......
...--..........--...
....................
.GBG............GAG.
####............####
....................
.1...........ACA....
#########..#########
